111111111111111111111111111111111111
111111111111111111111111111111111111
111111111111111111111111111111111111
100010000010100000010000000000001001
100110000000101000010000000000001111
111111000000000000000000000000001111
100000010000010000000000000000001001
111100010000000101000000000000001001
111100010000000000000000011100000001
111100010000011110000000000001001001
100000000000010010000000000000001001
100000010000010011100000000000001001
10000001000000001P000000000000001001
100000010000010011100000000000001001
100000010000000000000000000000001111
100000000000000000E00000110000001111
10000000000000000C000000110000001111
100000000000000000000000000000001111
100000000000000000000000111000001111
100000100000000000000000000110001111
100000100000000000000000000000000001
111111111111111111111111111111111111