11111111111111111111111111
10000000000010001000001001
1E001CC0000010001100000001
10001000000000001000001001
10011000000000001000001111
10000001000000000000001111
10000001000000000000001001
11110001000000000000001001
11110001000000000000000001
11110001000001111000001001
10000001000001001000001001
10000001000001001000001001
10000001000000001P00001001
10000001000001001000001001
11111111111111111111111111
11111111111111111111111111
11111111111111111111111111