1111111111111
1000000001111
1E001CC001111
1000100001111
1001P00001111
1111111111111
1111111111111
1111111111111