11111
1P101
10101
10101
10101
10001
11111
1C101
10001
1E001
11111