11111
10001
10001
10001
1C001
1E001
1P001
11111